9
9
04,04,04,04,04,04,04,04,04
04,16,16,16,16,04,16,06,04
04,16,16,11,16,04,16,13,04
04,16,16,16,16,04,16,16,04
04,16,16,16,16,04,16,16,04
04,04,04,04,13,04,16,16,04
04,16,13,16,16,16,16,16,04
04,06,16,16,16,16,16,16,04
04,04,04,04,04,04,16,16,04
